1,1,1,1,1,1,1,1,1,1,1,1,1,1,1,1,1,1,1,1,
1,0,0,0,0,5,5,5,5,5,0,0,0,1,1,5,5,5,5,1,
1,0,0,0,0,5,5,5,5,5,0,0,0,1,1,5,5,5,5,1,
1,5,5,5,5,1,1,1,1,1,0,0,0,1,1,5,5,5,5,1,
1,5,5,5,5,1,1,5,6,5,0,0,0,0,0,0,0,0,0,1,
1,5,5,5,5,1,1,6,7,6,0,0,0,0,0,4,0,0,0,1,
1,5,5,5,5,1,1,5,6,5,1,1,1,1,1,1,1,0,0,1,
1,0,0,0,0,0,0,0,0,0,5,5,5,5,5,5,5,0,0,1,
1,3,0,0,0,0,0,0,0,0,5,5,5,5,5,5,5,0,0,1,
1,1,1,1,1,1,1,1,1,1,1,1,1,1,1,1,1,1,1,1