1,1,1,1,1,1,1,1,1,1,1,1,1,1,1,1,1,1,1,1,
1,0,0,0,0,0,5,6,7,0,0,0,0,1,1,0,5,5,0,1,
1,0,0,0,0,0,5,6,7,0,0,0,0,1,1,0,5,5,0,1,
1,0,0,0,0,1,1,1,1,1,0,0,0,1,1,0,0,0,0,1,
1,0,0,0,0,1,1,0,0,0,7,0,0,0,0,0,0,0,0,1,
1,0,0,0,0,1,1,0,0,7,0,0,0,0,0,4,0,0,5,1,
1,0,0,0,0,1,1,0,7,0,1,1,1,1,1,1,1,0,5,1,
1,0,0,0,0,0,0,0,0,0,0,0,0,0,0,0,0,0,5,1,
1,3,0,0,0,0,0,0,0,0,5,6,7,7,6,5,0,0,0,1,
1,1,1,1,1,1,1,1,1,1,1,1,1,1,1,1,1,1,1,1