1,1,1,1,1,1,1,1,1,1,1,1,1,1,1,1,1,1,1,1,
1,1,1,1,1,1,0,0,0,0,0,0,0,0,1,1,1,1,1,1,
1,1,1,1,1,1,0,5,5,5,5,5,5,0,1,1,1,1,1,1,
1,1,1,1,1,1,0,0,0,0,0,0,0,0,1,1,1,1,1,1,
1,0,0,0,0,5,5,0,1,0,0,1,0,5,5,0,0,0,0,1,
1,0,0,0,5,0,0,0,1,0,0,1,0,0,0,5,0,0,0,1,
1,0,0,5,0,1,1,1,1,0,0,1,1,1,1,0,5,0,0,1,
1,0,0,0,0,0,0,0,0,0,0,0,0,0,0,0,0,0,0,1,
1,3,0,0,0,0,0,0,6,6,6,6,0,0,0,0,0,0,4,1,
1,1,1,1,1,1,1,1,1,1,1,1,1,1,1,1,1,1,1,1