1,1,1,1,1,1,1,1,1,1,1,1,1,1,1,1,1,1,1,1,
1,5,5,5,5,5,5,5,5,5,5,5,5,5,5,5,5,5,5,1,
1,5,5,5,5,5,5,5,5,5,5,5,5,5,5,5,5,5,5,1,
1,5,5,5,5,5,5,5,5,5,5,5,5,5,5,5,5,5,5,1,
1,5,5,5,5,5,5,5,5,5,5,5,5,5,5,5,5,5,5,1,
1,5,5,5,5,5,5,5,5,5,5,5,5,5,5,5,5,5,5,1,
1,5,5,5,5,5,5,5,5,5,5,5,5,5,5,5,5,5,5,1,
1,5,5,5,5,5,5,5,5,5,5,5,5,5,5,5,5,5,5,1,
1,3,5,5,5,5,5,5,5,5,5,5,5,5,5,5,5,5,4,1,
1,1,1,1,1,1,1,1,1,1,1,1,1,1,1,1,1,1,1,1