1,1,1,1,1,1,1,1,1,1,1,1,1,1,1,1,1,1,1,1,
1,7,7,7,7,7,7,7,7,7,7,7,7,7,7,7,7,7,7,1,
1,7,7,7,7,7,7,7,7,7,7,7,7,7,7,7,7,7,7,1,
1,7,7,7,7,7,7,7,7,7,7,7,7,7,7,7,7,7,7,1,
1,7,7,7,7,7,7,7,7,7,7,7,7,7,7,7,7,7,7,1,
1,7,7,7,7,7,7,7,7,7,7,7,7,7,7,7,7,7,7,1,
1,7,7,7,7,7,7,7,7,7,7,7,7,7,7,7,7,7,7,1,
1,7,7,7,7,7,7,7,7,7,7,7,7,7,7,7,7,7,7,1,
1,3,7,7,7,7,7,7,7,7,7,7,7,7,7,7,7,7,4,1,
1,1,1,1,1,1,1,1,1,1,1,1,1,1,1,1,1,1,1,1