1,1,1,1,1,1,1,1,1,1,1,1,1,1,1,1,1,1,1,1,
1,0,0,6,6,0,0,0,0,0,0,0,0,0,0,0,0,0,0,1,
1,0,0,6,6,0,0,0,0,0,0,0,0,0,0,0,0,0,0,1,
1,0,0,1,1,0,0,1,0,0,0,1,1,1,1,1,1,0,0,1,
1,5,5,0,0,5,5,1,0,3,0,1,0,0,5,7,5,0,0,1,
1,5,5,0,0,5,5,1,1,1,1,1,0,0,5,7,5,0,0,1,
1,1,1,0,0,1,1,0,0,0,0,0,0,0,1,1,1,1,1,1,
1,7,5,0,0,0,0,0,0,4,0,0,0,0,1,1,1,1,1,1,
1,7,5,0,0,0,0,0,0,1,1,0,0,0,1,1,1,1,1,1,
1,1,1,1,1,1,1,1,1,1,1,1,1,1,1,1,1,1,1,1