1,1,1,1,1,1,1,1,1,1,1,1,1,1,1,1,1,1,1,1,1,1,1,1,1,1,1,1,1,1,1,1,1,1,1,
1,0,0,0,0,4,0,0,0,0,1,0,0,0,0,0,1,0,0,0,0,0,0,0,1,0,0,0,0,0,0,0,0,0,1,
1,0,0,0,0,4,0,0,0,0,1,0,0,0,0,0,1,0,0,0,0,0,0,0,1,0,0,0,0,0,6,0,0,0,1,
1,0,0,0,0,4,0,6,6,0,1,0,1,1,1,0,1,0,0,0,0,0,0,0,1,0,0,1,1,1,1,1,0,0,1,
1,0,0,0,1,1,1,1,1,0,1,0,0,0,1,0,1,0,0,1,1,1,0,0,1,0,0,0,0,0,0,1,0,0,1,
1,0,0,0,0,1,0,0,0,0,1,0,0,0,1,0,1,0,0,0,0,1,0,4,1,1,0,0,0,0,0,1,0,0,1,
1,0,0,0,5,1,0,0,0,0,1,1,1,0,1,0,0,4,0,0,0,1,0,1,1,0,0,0,4,6,0,1,0,0,1,
1,0,0,1,1,1,0,0,0,5,1,0,0,0,1,0,1,1,1,1,0,1,0,0,1,0,0,1,1,1,1,1,0,0,1,
1,0,0,0,0,1,0,1,1,1,1,0,1,4,1,0,0,0,6,1,0,1,0,0,0,0,0,1,0,0,0,0,0,0,1,
1,3,0,0,0,1,0,0,0,6,0,0,1,0,1,0,0,0,5,6,0,1,4,0,0,0,5,1,2,0,6,6,0,0,1,
1,1,1,1,1,1,1,1,1,1,1,1,1,1,1,1,1,1,1,1,1,1,1,1,1,1,1,1,1,1,1,1,1,1,1,