1,1,1,1,1,1,1,1,1,1,1,1,1,1,1,1,1,1,1,1,
1,6,6,6,6,6,6,6,6,6,6,6,6,6,6,6,6,6,6,1,
1,6,6,6,6,6,6,6,6,6,6,6,6,6,6,6,6,6,6,1,
1,6,6,6,6,6,6,1,1,6,6,6,6,6,6,1,1,6,6,1,
1,6,6,6,6,6,6,1,1,6,6,6,6,6,6,1,1,6,6,1,
1,6,6,1,1,6,6,6,6,6,6,1,1,6,6,6,6,6,6,1,
1,6,6,1,1,6,6,6,6,6,6,1,1,6,6,6,6,6,6,1,
1,6,6,6,6,6,6,6,6,6,6,6,6,6,6,6,6,6,6,1,
1,3,6,6,6,6,6,6,6,6,6,6,6,6,6,6,6,6,4,1,
1,1,1,1,1,1,1,1,1,1,1,1,1,1,1,1,1,1,1,1